   ******
   * xxx*
****xxxx*
*  ***o ***
* o o  oo *
*p o o    *
*   ***   *
***********
