*****
*   *
* op* ***
* oo* *x*
*** ***x*
 **    x*
 *   *  *
 *   ****
 *****