      ***
      *x*
  *****x*****
 **         **
**  * * * *  **
*  **     **  *
* **  * *  ** *
*     opo     *
****  ***  ****
   **** ****