*****
*   *
* o * ***
* op* *x*
***o***x*
**     x*
*    *  *
*    ****
******