 ****
 *p ***
 * o  *
*** * **
*x* *  *
*xo  * *
*x   o *
********